############
#        O #
#   P   ####
#          #
#######    #
#   O##  X #
#   O##    #
#          #
#      XX  #
#      #   #
############